ἅ - relative pronoun; accusative plural neuter of <ὅς> - who, which

αἱ - article; nominative plural feminine of <ὁ> - the

ἀγάμενοι - deponent verb; nominative plural masculine of present participle middle of <ἄγαμαι> - to wonder, admire

ἀγάμενος - deponent verb; nominative singular masculine of middle participle of <ἄγαμαι> - to wonder, admire

ἀγγέλους - noun, masculine; accusative plural of <ἄγγελος> - messenger - var.os-ous

Αἰγεὺς - noun, masculine; nominative singular of <Αἰγεύς> - Aegeus - var.pname

Αἵδι - noun, masculine; dative singular of <Αἵδης> - Hades - var.pname

ἀδάμαντος - noun, masculine; genitive singular of <ἀδάμας> - steel - var.as-antos

Ἀδείμαντε - noun, masculine; vocative singular of <Αδείμαντος> - Adeimontus - var.pname

ἀδικούμενα - verb; accusative plural neuter of passive participle of <ἀδικέω> - wrong

ἀδικοῦντα - verb; accusative plural neuter of participle of <ἀδικέω> - wrong

ἄειδε - verb; 2nd person singular imperative of <ἀείδω> - sing, chant

ἀέθλων - noun, masculine; genitive plural of <ἀέθλος> - battle, woe - var.os

ἁζόμενοι - verb; nominative plural masculine of present participle middle of <ἅζομαι> - stand in awe of

ἀθάνατοι - adjective; nominative plural masculine of <ἀθάνατος> - immortal - var.os--on

ἁθρόοι - adjective; nominative plural masculine of <ἁθρόος> - together - var.os--a--on

ἀκηδέα - adjective; accusative singular masculine of <ἀκήδης> - without sorrow - var.hs-es

ἀκηκοότα - verb; nominative plural neuter of perfect participle of <ἀκούω> - hear, listen

# ἀκλεᾶ - adjective; nominative plural neuter of <ἀκλεός> - without fame - var TODO: нет в словарях, нет парадигмы

ἀκούουσι - verb; 3rd person plural present of <ἀκούω> - hear, listen

ἀκούσας - verb; nominative singular masculine of aorist participle of <ἀκούω> - hear, listen

ἄκρον - noun, neuter; accusative singular of <ἄκρον> - mountain-top, peak - var.on

ἄλγε' - noun, neuter; accusative plural of <ἄλγος> - woe - var.os-ous

ἄλγεα - noun, neuter; accusative plural of <ἄλγος> - woe

Ἀλέξανδρον - noun, masculine; accusative singular of <Ἀλέξανδρος> - Alexandros - var.os

ἀληθῶς - adverb; <ἀληθῶς> - really, truly

Ἁλικαρνησσέος - noun, masculine; genitive singular of <Ἁλικαρνησεύς> - Halicarnassian - var.pname

ἀλλ' - conjunction; <ἀλλά> - but

ἀλλὰ - conjunction; <ἀλλά> - but

ἀλλήλοισι - pronoun; dative plural masculine of <ἀλλήλων> - one another

ἀλλήλους - pronoun; accusative plural masculine of <ἀλλήλων> - one another

ἀλλήλων - pronoun; genitive plural neuter of <ἀλλήλων> - one another

ἀλλήλων - pronoun; genitive plural masculine of <ἀλλήλων> - one another

ἄλλοι - adjective; vocative plural masculine of <ἄλλος> - other

ἄλλοι - adjective; nominative plural masculine of <ἄλλος> - other

ἄλλο - adjective; accusative singular neuter of <ἄλλος> - other

ἄλλους - adjective; accusative plural masculine of <ἄλλος> - other

ἄλλων - adjective; genitive plural masculine of <ἄλλος> - other

ἄλλως - adverb; <ἄλλως> - otherwise, especially

ἅμα - adverb; <ἅμα> - at the same time

ἀμειξίαν - noun, feminine; accusative singular of <ἀμειξία> - lack of intercourse - var.a

ἁμόθεν - adverb; <ἁμόθεν> - from any point

ἀμφὶ - preposition; <ἀμφί> - around, between

ἂν - particle; <ἄν> - if

ἄν - particle; <ἄν> - if

ἀνὰ - preposition; <ἀνά> - on

ἀναβὰς - verb; nominative singular masculine of aorist participle of <ἀναβαίνω> - mount, go up

ἀνακαλεῖ - verb; 3rd person singular present of <ἀνακαλέω> - designate

ἀναλαβὼν - verb; nominative singular masculine of participle of <ἀναλαμβάνω> - take along

ἄναξ - noun, masculine; nominative singular of <ἄναξ> - ruler

ἀνδρῶν - noun, masculine; genitive plural of <ἀνήρ> - man

ἀνήγετο - verb; 3rd person singular present middle of <ἀνάγομαι> - put out to sea

ἀντιθέῳ - adjective; dative singular masculine of <ἀντίθεος> - godlike - var.os--on

ἀντίπαλον - noun, masculine; accusative singular of <ἀντίπαλος> - contrast - var.os

ἅπαντες - adjective; nominative plural masculine of <ἅπας> - all - var.as-antos

ἀπαιρέουσαι - verb; nominative singular feminine of present participle of <ἀπαιρέω> - take off

ἅπασιν - adjective; dative plural masculine of <ἅπας> - all

ἀπαιτέειν - verb; infinitive of <ἀπαιτέω> - request

ἀπαιτεόντων - verb; genitive plural neuter of present participle of <ἀπαιτέω> - request

ἀπέκτεινάν - verb; 3rd person plural imperfect of <ἀποκτείνω> - kill

ἀπερείσι' - adjective; accusative plural neuter of <ἀπερείσιος> - countless - var.os--on

ἀπείρονα - adjective; accusative singular feminine of <ἀπείρων> - boundless - var.wn-on

ἀπὸ - preposition; <ἀπό> - from

ἀπόδεξις - noun, feminine; nominative singular of <ἀπόδεξις> - exposition, publication - var.is-eos

ἀποδεχθέντα - verb; nominative plural neuter of aorist participle passive of <ἀποδείκνυμι> - propose

ἀποκεκρίσθαι - verb; perfect infinitive passive of <ἀποκρίνω> - separate, answer

ἀποκρατήσειε - verb; 3rd person singular aorist optative of <ἀποκρατέω> - exceed

Ἀπόλλωνα - noun, masculine; accusative singular of <Ἀπόλλων> - Apollo - var.wn-on

Ἀπόλλωνος - noun, masculine; genitive singular of <Ἀπόλλων> - Apollo

ἄποινα - noun, neuter; accusative plural of <ἄποινα> - ransom - var.excl

ἀπότομος - adjective; nominative singular feminine of <ἀπότομος> - precipitous - var.os--on

Ἀπτέρου - adjective; genitive singular feminine of <Ἄπτερος> - Wingless - var.os--on

αἰπὺν - adjective; accusative singular masculine of <αἰπύς> - deep - var.us

ἆρ' - interrogative particle; <ἆρ'> - then

ἆρα - interrogative particle; <ἆρα> - then

Ἀριάδνην - noun, feminine; accusative singular of <Ἀριάδνη> - Ariadne - var.h

Ἀργείους - noun, masculine; accusative plural of <Ἀργεῖος> - Argive - var.pname

ἀργύρεον - adjective; accusative singular neuter of <ἀργύρεος> - silver - var.os--a--on

ἀργυρέῳ - adjective; dative singular neuter of <ἀργύρεος> - silver

ἄρειον - adjective; accusative singular neuter of comparative of <ἄγαθος> - good - var.os--h--on

ἀρετῆς - noun, feminine; genitive singular of <ἀρετῆ> - virtue - var.h

Ἄρηος - noun, masculine; genitive singular of <Ἄρης> - Ares - var.hs

ἀρητῆρα - noun, masculine; accusative singular of <ἀρητήρ> - priest - var.hr-eros

ἁρμόττοντα - verb; accusative plural neuter of present participle of <ἁρμόττω> - fit together

ἀρνύμενος - verb; nominative singular masculine of present participle middle of <ἄρνυμαι> - win, seeking to save

ἄρξαι - verb; infinitive aorist of <ἄρχω> - begin

ἁρπαγὰς - noun, feminine; accusative plural of <ἁρπαγή> - abduction - var.h

ἁρπαγήν - noun, feminine; accusative singular of <ἁρπαγή> - abduction

ἁρπαγῆς - noun, feminine; genitive singular of <ἁρπαγή> - abduction

ἁρπάσαντος - verb; genitive singular masculine of <ἁρπάζω> - carry off

ἀρχαῖοι - adjective; nominative plural masculine of <ἀρχαιος> - old - var.os--a--on

ἀρχὴ - noun, feminine; nominative singular of <ἀρχή> - beginning, first principle - var.h

Ἀσίην - noun, feminine; accusative singular of <Ἀσία> - Asia - var.a

ἀσθένειαν - noun, feminine; accusative singular of <ἀσθένεια> - weakness - var.a

ἀσπερχὲς - adverb; <ἀσπερχές> - unceasingly

ἄστεα - noun, neuter; accusative plural of <ἄστυ> - city - var.u-eos

ἀτασθαλίησιν - noun, feminine; dative plural of <ἀτασθαλία> - folly - var.a-atos

αἰτέειν - verb; infinitive present, of <αἰτέω> - request

ἄτερ - preposition; <ἄτερ> - without

αἰτίην - noun, feminine; accusative singular of <αἰτία> - cause, reason - var.a

ἀτμίδα - noun, feminine; accusative singular of <ἀτμίς> - steam, vapor - var.is-idos

αἰτίους - adjective; accusative plural masculine of <αἴτιος> - blameworthy - var.os--a--on

Ἀτρείδα - noun, masculine; accusative dual of <Ἀτρείδης> - son of Atreus - var.hs

Ἀτρείδαι - noun, masculine; vocative plural of <Ἀτρείδης> - son of Atreus

Ἀτρείδης - noun, masculine; nominative singular of <Ἀτρείδης> - son of Atreus

ἅττα - pronoun; accusative plural neuter of <ὅστις> - whoever, whatever

αὐτὰρ - conjunction; <αὐτάρ> - but

αὖτε - adverb; <αὖτε> - then, again

αὕτη - demonstrative pronoun; nominative singular feminine of <οὗτος> - this

αὐτὴν - pronoun; accusative singular feminine of <αὐτός> - oneself, he

αὐτῆς - pronoun; genitive singular feminine of <αὐτός> - oneself, he

αὐτοὶ - pronoun; nominative plural masculine of <αὐτός> - oneself, he

αὐτομάτη - adjective; nominative singular feminine of <αὐτόματος> - by itself - var.os--on

αὐτὸν - pronoun; accusative singular masculine of <αὐτός> - oneself, he

αὐτοῖς - pronoun; dative plural masculine of <αὐτός> - oneself, he

αὐτοῦ - pronoun; genitive singular masculine of <αὐτός> - oneself, he

αὐτοὺς - pronoun; accusative plural masculine of <αὐτός> - oneself, he

αὔτις - adverb; <αὔτις> - again

αὐτῳ - pronoun; dative singular masculine of <αὐτός> - oneself, he

αὐτῶν - pronoun; genitive plural masculine of <αὐτός> - oneself, he

αὐτῶν - pronoun; genitive plural feminine of <αὐτός> - oneself, he

ἀφ' - preposition; <ἀπό> - from

ἀφείλετο - verb; 3rd person singular aorist middle of <ἀφαιρέω> - take away

ἀφεὶς - verb; nominative singular masculine of aorist participle of <ἀφίημι> - send forth, throw down, permit, forgive

ἀφῃρημένος - verb; nominative singular masculine of passive participle of <ἀφαιρέω> - take away

ἀφικνοῦνται - deponent verb; 3rd person plural present of <ἀφικνέομαι> - come to, reach

ἀφίκοντο - deponent verb; 3rd person plural aorist of <ἀφικνέομαι> - come to, reach

ἀφομοιοῦσθαι - verb; passive infinitive of <ἀφομοιο̃ω> - to make like

Ἀχαιοί - noun, masculine; vocative plural of <Ἀχαιός> - Achaean - var.os--a--on

Ἀχαιοῖς - noun, masculine; dative plural of <Ἀχαιός> - Achaean

Ἀχαιοὺς - noun, masculine; accusative plural of <Ἀχαιός> - Achaean

Ἀχαιούς - noun, masculine; accusative plural of <Ἀχαιός> - Achaean

Ἀχαιῶν - noun, masculine; genitive plural of <Ἀχαιός> - Achaean

Ἀχιλλεύς - noun, masculine; nominative singular of <Ἀχιλλεύς> - Achilles - var.us

Ἀχιλλέως - noun, masculine; genitive singular of <Ἀχιλλεύς> - Achilles

Ἀχιλλῆος - noun, masculine; genitive singular of <Ἀχιλλεύς> - Achilles

βάρβαρα - adjective; accusative plural neuter of <βάρβαρος> - foreign, not Greek - var.os--on

βαρβάροισι - noun, masculine; dative plural of <βάρβαρος> - foreigner, non-Greek

βαρβάρους - noun, masculine; accusative plural of <βάρβαρος> - foreigner, non-Greek

βασιλῆι - noun, masculine; dative singular of <βασιλεύς> - king - var.diph-eos

βλέπειν - verb; infinitive of <βλέπω> - see

βοὴ - noun, feminine; nominative singular of <βοή> - shout - var.h

βουλή - noun, feminine; nominative singular of <βουλή> - will - var.h

βουλοίατό - verb; 3rd person singular aorist optative of <βούλομαι> - wish, request

βοῦς - noun, masculine; accusative plural of <βοῦς> - cow, ox - var.diph-ous

βοῶν - noun, masculine; genitive plural of <βοῦς> - cow, ox

βοῶντας - verb; accusative plural masculine of present participle of <βοάω> - shout

βοώντων - verb; genitive plural masculine of participle of <βοάω> - shout

γ' - particle; <γε> - indeed

γαῖα - noun, feminine; nominative singular of <γαῖα> - land - var.a

γαῖαν - noun, feminine; accusative singular of <γαῖα> - land

γὰρ - conjunction; <γάρ> - for

γάρ - conjunction; <γάρ> - for

γίγνεται - deponent verb; 3rd person singular present of <γίγνομαι> - happen, become

γε - particle; <γε> - indeed

γενεῇ - noun, feminine; dative singular of <γενεή> - family, generation, race - var.h

γενεὴ - noun, feminine; nominative singular of <γενεή> - family, generation, race

γενέσθαι - deponent verb; infinitive aorist of <γίγνομαι> - happen, become

γένεται - deponent verb; 3rd person singular present subjunctive of <γίγνομαι> - happen, become

γενήσεσθαι - deponent verb; infinitive future middle of <γίγνομαι> - happen, become

γένηται - deponent verb; 3rd person singular aorist middle of <γίγνομαι> - happen, become

γενόμενα - participle; nominative plural neuter of present participle middle of <γίγνομαι> - happen, become

γενόμενος - deponent verb; nominative singular neuter of present participle middle of <γίγνομαι> - happen, become

γένος - noun, neuter; nominative singular of <γένος> - race - var.os-ous

γένος - noun, neuter; accusative singular of <γένος> - race

γέρρα - noun, neuter; accusative plural of <γέρρον> - ox-hide wicker shield - var.on

γλαφυροῖσι - adjective; dative plural neuter of <γλαφυρός> - hollow - var.os--a--on

γίνεσθαι - deponent verb; aorist infinitive of <γίγνομαι> - happen, become

γίνονται - deponent verb; 3rd person plural present of <γίγνομαι> - happen, become

γραφικῆς - noun, feminine; genitive singular of <γραφικῆ> - painting - var.h

γυναῖκα - noun, feminine; accusative singular of <γυνή> - woman - var.h

γυναῖκες - noun, feminine; nominative plural of <γυνή> - woman

γυναικὸς - noun, feminine; genitive singular of <γυνή> - woman

δι' - preposition; <διά> - through, by

δ' - particle; <δέ> - and, on the other hand

διὰ - preposition; <διά> - through, by

δῖα - adjective; nominative singular feminine of <δῖος> - godlike, noble - var.os--a--on

ἰδίᾳ - adverb; <ἰδίᾳ> - privately

διαβολὴ - noun, feminine; nominative singular of <διαβολή> - false accusation, calumny - var.h

διαγνοίη - verb; 3rd person singular optative aorist of <διαγιγνώσκω> - discern, distinguish

δακρύοντες - verb; nominative plural masculine of present participle of <δακρύω> - weep

Δαναοὺς - noun, masculine; accusative plural of <Δαναοί> - Danaans - var.pname

διάνοια - noun, feminine; nominative singular of <διάνοια> - thought, mind - var.a

διάνοιαν - noun, feminine; accusative singular <διάνοια> - thought, mind

δασειῶν - adjective; genitive plural masculine of <δασύς> - hairy, shaggy - var.us

διαστήτην - verb; 2nd person dual aorist middle of <δι-ίστημι> - separate, strive

διαφανέας - adjective; accusative plural masculine of <διαφανής> - transparent, red-hot - var.hs-es

διαφθείρεται - verb; 3rd person singular present middle of <διαφθείρω> - destroy, kill

δὲ - particle; <δέ> - and, on the other hand

δέ - particle; <δέ> - and, on the other hand

ἴδεν - verb; 3rd person singular aorist of <εἴδω> - see, know

δεινόν - adjective; accusative singular neuter of <δεινός> - terrible - var.os--h--on

δεξίᾳ - noun, feminine; dative singular of <δεξιά> - the right hand - var.a

Δευκαλίωνος - noun, masculine; genitive singular of <Δευκαλίων> - Deucalion - var.wn-on

δευτέρῃ - adjective; dative singular feminine of <δεύτερος> - second - var.os--a--on

δεύτερον - adverb; <δεύτερον> - second

δεύτερον - adjective; accusative singular neuter of <δεύτερος> - second

δέχεσθαι - verb; infinitive of <δέχομαι> - receive

δὴ - particle; <δή> - indeed

δηλοῖ - verb; 3rd person singular present of <δηλόω> - be clear, reveal

δῆλον - adjective; nominative singular neuter of <δῆλος> - clear, obvious - var.os--h--on

δημοσίᾳ - adverb; <δημοσίᾳ> - in public

δημοτικῆς - adjective; genitive singular feminine of <δημοτικός> - of the people, in common use - var.os--h--on

δημιουργὸν - noun, masculine; accusative singular of <δημιουργός> - craftsman - var.os

δικαιοσύνης - noun, feminine; genitive singular of <δικαιοσύνη> - justice, righteousness - var.h

δικαιότερον - adjective; accusative singular neuter of comparative of <δίκαιος> - just, righteous - var.os--a--on

δίκας - noun, feminine; accusative plural of <δίκη> - custom, right - var.h

δοῖεν - verb; 3rd person plural optative aorist of <δίδωμι> - give

δοκεῖ - verb; 3rd person singular present of <δοκέω> - seem, think

δοκήσει - verb; 3rd person singular future of <δοκέω> - seem, think

δοκῶν - verb; present participle nominative singular masculine of <δοκέω> - seem, think

δόντες - verb; nominative plural masculine of aorist participle of <δίδωμι> - give

δόξαι - verb; aorist infinitive of <δοκέω> - seem, think

διόπερ - adverb; <διόπερ> - therefore, so

δῖος - adjective; nominative singular masculine of <δῖος> - godlike, noble

Διὸς - noun, masculine; genitive singular of <Ζεύς> - Zeus - var.excl

Διός - noun, masculine; genitive singular of <Ζεύς> - Zeus

δρόμῳ - noun, masculine; dative singular of <δρόμος> - run - var.os

δύναμιν - noun, feminine; accusative singular of <δύναμις> - power - var.is-eos

δύνασθαι - deponent verb; infinitive of <δύναμαι> - be able

δυνατὸν - noun, neuter; accusative singular of <δυνατός> - possible - var.os

δυσμενείας - noun, feminine; genitive singular of <δυσμένεια> - enmity, hate - var.a

δύω - number; dual of <δύο> - two

δώματ' - noun, neuter; accusative plural of <δῶμα> - house, home - var.a-atos

δώσει - verb; 3rd person singular aorist subjunctive of <δίδωμι> - give

δώσουσι - verb; 3rd person plural future of <δίδωμι> - give

εἰ - conjunction; <εἰ> - if

ἑαυτὸν - reflexive pronoun; accusative singular masculine of <ἑαυτός> - himself

ἑαυτῶν - reflexive pronoun; genitive plural masculine of <ἑαυτός> - himself

ἐγίγνετο - deponent verb; 3rd person singular imperfect middle of <γίγνομαι> - happen, become

ἐγίγνοντο - deponent verb; 3rd person plural imperfect of <γίγνομαι> - happen, become

# ἐγγύτερον - adjective; nominative singular feminine comparative of <ἐγγύς> - near # TODO - это целый класс

ἐγγύς - adverb; <ἐγγύς> - near

ἐγένετο - deponent verb; 3rd person singular aorist of <γίγνομαι> - happen, become

ἐγένοντο - deponent verb; 3rd person plural aorist of <γίγνομαι> - happen, become

ἔγνω - verb; 3rd person singular aorist of <γιγνώσκω> - know, learn

εἶδέ - verb; 3rd person singular aorist of <εἶδον> - saw

εἶδεν - verb; 3rd person singular aorist of <εἶδον> - saw

ἐδόκει - verb; 3rd person singular imperfect of <δοκέω> - seem, think

ἐδύνατο - deponent verb; 3rd person singular imperfect of <δύναμαι> - be able

ἐζώγρησαν - verb; 3rd person plural aorist of <ζωγρέω> - capture alive

ἔζωον - verb; 3rd person plural imperfect of <ζώω> - live

εἴη - verb; 3rd person singular present optative of <εἰμί> - I am

ἐθελῆσαί - verb; infinitive aorist of <ἐθέλω> - wish, want

ἔθεον - verb; 3rd person plural imperfect of <θέω> - run

ἔθηκε - verb; 3rd person singular aorist of <τίθημι> - put, place

ἔθνεα - noun, neuter; accusative plural of <ἔθνος> - nation, people, tribe - var.os-ous

ἔθνη - noun, neuter; accusative plural of <ἔθνος> - nation, people, tribe

ἐκ - preposition; <ἐκ> - from, out of

ἕκαστοι - pron; nominative plural masculine of <ἕκαστος> - each, every - var.os

ἑκάστους - pron; accusative plural masculine of <ἕκαστος> - each, every

ἐκδόντες - verb; nominative plural masculine of aorist participle of <ἐκδιδώμι> - give up

ἐκεῖ - adverb; <ἐκεῖ> - there

ἐκεῖνο - demonstrative pronoun; accusative singular neuter of <ἐκεῖνος> - that

ἑκηβόλον - adjective; accusative singular masculine of <ἑκηβόλος> - far-shooting - var.os--on

ἑκηβόλου - adjective; genitive singular masculine of <ἑκηβόλος> - far-shooting

ἐκνικῆσαι - verb; infinitive passive of <ἐκνικάω> - prevail

εἰκόνα - noun, feminine; accusative singular of <εἰκών> - image, portrait - var.wn-on

εἰκόνας - noun, feminine; accusative plural <εἰκών> - image, portrait

εἴκοσιν - number; accusative plural neuter of <εἴκοσι> - twenty

ἐκπέρσαι - verb; aorist infinitive of <ἐκπέρθω> - destroy

ἔλαβον - verb; 3rd person plural aorist of <λαμβάνω> - receive, capture

ἐλέαιρον - verb; 3rd person plural imperfect of <ἐλεαίρω> - pity

Ἑλένην - noun, feminine; accusative singular of <Ἑλένη> - Helen - var.h

ἐλθόντας - verb; accusative plural masculine of aorist participle of <ἔρχομαι> - come, go

Ἑλλάδος - noun, feminine; genitive singular of <Ἑλλάς> - Greece - var.as-ados

Ἑλλάς - noun, feminine; nominative singular of <Ἑλλάς> - Greece

Ἕλληνάς - noun, masculine; accusative plural of <Ἕλλην> - Greek - var.hn-enos

Ἕλληνας - noun, masculine; accusative plural of <Ἕλλην> - Greek

Ἕλληνες - noun, masculine; nominative plural of <Ἕλλην> - Greek

Ἑλληνικὴ - adjective; nominative singular feminine of <Ἑλληνικός> - Greek - var.os--h--on

Ἑλληνικὸν - adjective; accusative singular neuter of <Ἑλληνικός> - Greek

Ἕλληνος - noun, masculine; nominative singular of <Ἕλληνος> - Hellenos - var.os

Ἕλλησι - noun, masculine; dative plural of <Ἕλλην> - Greek

ἑλώρια - noun, neuter; accusative plural of <ἑλώριον> - spoils, booty - var.on - var.on

εἷμα - noun, neuter; nominative singular of <εἷμα> - clothing - var.a-atos

εἵματα - noun, neuter; accusative plural of <εἷμα> - clothing

ἐμβασίλευεν - verb; 3rd person singular imperfect of <ἐμβασιλεύω> - be king in

ἔμελε - verb; 3rd person singular imperfect of <μέλω> - to care, to be an object of care

ἱέμενός - deponent verb; nominative singular masculine of present participle of <ἵεμαι> - desire

ἐμμέτρων - adjective; genitive plural masculine of <ἔμμετρος> - metrical - var.os--on

ἐμοὶ - pronoun; dative singular masculine of <ἐγώ> - I

ἐμοῦ - pronoun; genitive singular masculine of <ἐγώ> - I

ἔμπης - adverb; <ἔμπης> - nevertheless

ἐμπίπλασθαι - verb; infinitive passive of <ἐμπίπλημι> - fill

ἔμπροσθεν - adverb; <ἔμπροσθεν> - before, in front

ἐμφερεστάτη - adjective; nominative singular feminine of superlative of <ἐμφέρης> - resembling - var.hs-es

ἐν - preposition; <ἐν> - in

εἶναι - verb; infinitive of <εἰμί> - I am

ἐναλίγκιον - adjective; accusative singular neuter of <ἐναλίγκιος> - resembling, like - var.os--on

ἐναλείψειε - verb; 3rd person singular aorist optative of <ἐναλείψω> - paint, smear

ἐνιαυτῶν - noun, masculine; genitive plural of <ἐνιαυτός> - year - var.os

ἐνέδραν - noun, feminine; accusative singular of <ἐνέδρα> - ambush - var.a

εἵνεκεν - preposition; <εἵνεκεν> - because of

ἔνθ' - adverb; <ἔνθα> - then, there

ἔνθα - adverb; <ἔνθα> - then, there

ἔννεπε - verb; 2nd person singular imperative of <ἐνέπω> - tell, tell of

ἐνοικέοντα - verb; accusative plural neuter of present participle of <ἐνοικέω> - dwelling in

ἐνόντα - verb; accusative plural neuter of participle of <ἔνειμι> - to be in, to be possible

ἐνταῦθα - adverb; <ἐνταῦθα> - then, there

ἐντεῦθεν - adverb; <ἐντεῦθεν> - from there

ἐξ - preposition; <ἐξ> - from, out of

ἐξαπίνης - adverb; <ἐξαπίνης> - on a sudden

ἐξίτηλα - adjective; nominative plural neuter of <ἐξίτηλος> - fading, forgotten - var.os--on

ἐπὶ - preposition; <ἐπί> - on, about

ἐπ' - preposition; <ἐπί> - on, about

ἐπαγομένων - verb; genitive plural masculine of present participle passive of <ἐπάγω> - bring in, invite

ἐπιβαλλόμενον - verb; accusative singular neuter of present participle passive of <ἐπιβάλλω> - throw on

ἐπιβάλλουσι - verb; 3rd person plural present of <ἐπιβάλλω> - throw on

εἰπὲ - verb; 2nd person singular imperative of <λέγω> - say

ἐπεὶ - conjunction; <ἐπεί> - when, after

ἐπεὰν - conjunction; <ἐπεάν> - when, after

ἐπειδὴ - conjunction; <ἐπειδή> - after

ἐπεκλώσαντο - verb; 3rd person plural aorist middle of <ἐπικλώθω> - spin; decide

εἰπεῖν - verb; aorist infinitive of <λέγω> - say

ἔπερσεν - verb; 3rd person singular aorist of <πέρθω> - destroy, sack

ἔπεσι - noun, neuter; dative plural of <ἔπος> - words, saying - var.os-ous

ἔπειτα - adverb; <ἔπειτα> - thereupon

ἐπίκλησις - noun, feminine; nominative singular of <ἐπίκλησις> - name, title - var.is-eos

ἔπλει - verb; 3rd person singular imperfect of <πλέω> - sail

ἐπολέμησαν - verb; 3rd person plural aorist of <πολεμέω> - fight, be at war

εἶπον - verb; 1st person singular aorist of <λέγω> - say

ἐπιόντες - verb; nominative plural masculine of present participle of <ἐπίειμι> - come near

εἵποντο - verb; 3rd person plural imperfect of <ἕπομαι> - follow

ἐποίουν - verb; 3rd person plural imperfect of <ποιέω> - make, do

ἔπραξαν - verb; 3rd person plural aorist of <πράσσω> - achieve, manage

ἐπιστάμενον - deponent verb; accusative singular masculine of present participle of <ἐπίσταμαι> - know

ἐπιτίθεσθαι - verb; infinitive aorist middle of <ἐπιτίθημι> - attack

ἐπωνυμίαν - noun, feminine; accusative singular of <ἐπωνυμία> - name, designation - var.a

ἔργ' - noun, neuter; nominative plural of <ἔργον> - work, deed - var.on

ἔργα - noun, neuter; nominative plural of <ἔργον> - work, deed

ἐργασαμένη - verb; nominative singular feminine of aorist participle of <ἐργάζομαι> - work, make

ἔργον - noun, neuter; nominative singular of <ἔργον> - work, deed

ἔριδι - noun, feminine; dative singular of <ἔρις> - strife - var.is-idos

εἴρεται - verb; 3rd person singular present passive of <εἴρω> - speak, say

εἴρηκε - verb; 3rd person singular perfect of <εἴρω> - speak, say

ἑρμηνείαν - noun, feminine; accusative singular of <ἑρμηνεία> - interpretation - var.a

ἱερὸν - adjective; accusative singular neuter of <ἱερός> - sacred - var.os--a--on

ἐρρύσατο - verb; 3rd person singular aorist middle of <ῥύομαι> - save

ἐρίσαντε - verb; 2nd person dual aorist participle of <ἐρίζω> - quarrel

ἔρυκε - verb; 3rd person singular imperfect of <ἐρύκω> - hold back

εἰς - preposition; <εἰς> - towards

ἐς - preposition; <ἐς> - towards

ἔσαν - verb; 3rd person plural imperfect of <εἰμί> - I am

ἐσθλὰ - adjective; nominative plural neuter of <ἐσθλός> - good - var.os--h--on

εἰσιν - verb; 3rd person plural present of <εἰμί> - I am

ἔσοδος - noun, feminine; nominative singular of <ἔσοδος> - entrance - var.os

ἐστι - verb; 3rd person singular present of <εἰμί> - I am

ἔστι - verb; 3rd person singular present of <εἰμί> - I am

ἐστί - verb; 3rd person singular present of <εἰμί> - I am

ἐστὶ - verb; 3rd person singular present of <εἰμί> - I am

ἐστιν - verb; 3rd person singular present of <εἰμί> - I am

ἐστίν - verb; 3rd person singular present of <εἰμί> - I am

ἔστιν - verb; 3rd person singular present of <εἰμί> - I am

ἐστὶν - verb; 3rd person singular present of <εἰμί> - I am

ἔσχεν - verb; 3rd person singular aorist of <ἔχω> - have

ἔτι - adverb; <ἔτι> - still

ἔτ' - adverb; <ἔτι> - still

ἑτάρους - noun, masculine; accusative plural <ἕταρος> - comrade - var.os

ἑταίρων - noun, masculine; genitive plural of <ἕταιρος> - comrade - var.os

εἴτε - conjunction; <εἴτε> - whether...or

ἐτελείετο - verb; 3rd person singular imperfect passive of <τελείω> - fulfill, complete

ἐτελεύτησεν - verb; 3rd person singular aorist of <τελευτέω> - finish, die

ἑτέραν - adjective; accusative singular feminine of <ἕτερος> - other - var.os--a--on

ἔτος - noun, neuter; nominative singular of <ἔτος> - year - var.os-ous

εὔ - adverb; <εὔ> - well

εὐκνήμιδες - adjective; vocative plural masculine of <εὐκνῆμις> - well-greaved - var.is-idos

εὐπρέπειαν - noun, feminine; accusative singular of <εὐπρέπεια> - appearance, beauty - var.a

Εὐρώπην - noun, feminine; accusative singular of <Εὐρώπη> - Europe - var.h

εὐφράνειεν - verb; 3rd person singular optative aorist of <εὐφραίνω> - delight, please

εὐωδίη - noun, feminine; nominative singular of <εὐωδίη> - fragrant scent - var.h

ἐφ' - preposition; <ἐπί> - on, about

ἔφη - verb; 2nd person singular imperfect of <φημί> - say

ἔχει - verb; 3rd person singular present of <ἔχω> - have

εἶχεν - verb; 3rd person singular imperfect of <εἴχω> - have, be

ἔχον - verb; 3rd person plural imperfect of <ἔχω> - have

ἔχοντι - verb; dative singular masculine present participle of <ἔχω> - have

ἔχοντα - verb; accusative plural neuter of participle of <ἔχω> - have

ἔχοντες - verb; nominative plural masculine of present participle of <ἔχω> - have

ἔχουσα - verb; nominative singular feminine of present participle of <ἔχω> - have

ἔχουσιν - verb; 3rd person plural present of <ἔχω> - have

ἐχυρόν - adjective; accusative singular neuter of <ἐχυρός> - strong, secure - var.os--a--on

ἔχω - verb; 1st person singular present of <ἔχω> - have

ἔχων - verb; nominative singular masculine of present participle of <ἔχω> - have

Ζεὺς - noun, masculine; nominative singular of <Ζεύς> - Zeus

ἤ - conjunction; <ἤ> - or, than

ἢ - conjunction; <ἤ> - or, than

ἧ - adverb; <ἧ> - verily

ἡ - article; nominative singular feminine of <ὁ> - the

ἥ - relative pronoun; nominative singular feminine of <ὅς> - who, which

ἥγηνται - deponent verb; 3rd person plural present of <ἡγέομαι> - lead, regard, rule

ἡγήσασθαι - deponent verb; infinitive aorist of <ἡγέομαι> - lead, regard, rule

ἥδε - demonstrative pronoun; nominative singular feminine of <ὅδε> - this

ἠδὲ - conjunction; <ἠδέ> - and, also

ἤδη - adverb; <ἤδη> - already

Ἠελίοιο - noun, masculine; genitive singular of <Ἠέλιος> - Helios - var.os

ἦεν - verb; 3rd person singular imperfect of <εἶμι> - go

ἤθη - noun, neuter; accusative plural of <ἦθος> - custom, character - var.os-ous

ἤθη - noun, neuter; nominative plural of <ἦθος> - custom, character

ἦθος - noun, neuter; nominative singular of <ἦθος> - custom, character

ἦθος - noun, neuter; accusative singular of <ἦθος> - custom, character

ἤκιστα - adverb; <ἥκιστα> - least

ἥκιστά - adverb; <ἥκιστα> - least

ἠλαύνετο - verb; 3rd person singular imperfect middle of <ἐλαύνω> - set in motion

ἦλθε - verb; 3rd person singular aorist of <ἔρχομαι> - come, go

ἤλθε - verb; 3rd person singular aorist of <ἔρχομαι> - come, go

ἧμαρ - noun, neuter; accusative singular of <ἧμαρ> - day - var.as-atos

# ἡμέρᾳ - noun, feminine; dative singular of <ἡμέρα> - day - var.a

ἡμέρῃ - noun, feminine; dative singular of <ἡμέρα> - day

ἡμίθεοι - noun, masculine; nominative plural  of <ἡμίθεος> - demi-god - var.os

ἡμῖν - pronoun; dative plural of <ἐγώ> - I

ἤν - conjunction; <ἤν> - if

ἣν - possessive pronoun; accusative singular feminine of <ὅς> - his

ἥν - possessive pronoun; accusative singular feminine of <ὅς> - his

ἦν - verb; 3rd person singular imperfect of <εἰμί> - I am

Ἡροδότου - noun, masculine; genitive singular of <Ἡερόδοτος> - Herodotus - var.os

ἡρώων - noun, masculine; genitive plural of <ἥρως> - hero - var.ws-otos

ἧσαν - verb; 3rd person plural imperfect of <εἰμί> - I am

ἦσαν - verb; 3rd person singular plural imperfect of <εἰμί> - I am

ἤσθιον - verb; 3rd person plural aorist of <ἐσθίω> - eat

ἠτίμασεν - verb; 3rd person singular aorist of <ἀτιμάζω> - dishonor

θάλασσά - noun, feminine; nominative singular of <θάλασσα> - sea - var.a

θάλασσαν - noun, feminine; accusative singular of <θάλασσα> - sea

θαλάσσῃ - noun, feminine; dative singular of <θάλασσα> - sea

θάλαττα - noun, feminine; nominative singular of <θάλαττα> - sea - var.a

θεά - noun, feminine; vocative singular of <θεά> - goddess - var.a

θεάων - noun, feminine; genitive plural of <θεά> - goddess

θεοὶ - noun, masculine; nominative plural of <θεός> - god - var.os

θεῖον - adjective; accusative singular neuter of <θεῖος> - divine, godlike - var.os--a--on

θεῖος - adjective; nominative singular masculine of <θεῖος> - divine, godlike

θείῳ - noun, masculine; dative singular of <θεῖος> - deity, divinity

θεωμένους - deponent verb; accusative plural masculine of middle participle of <θεάομαι> - see

θεῶν - noun, masculine; genitive plural of <θεός> - god

Θησεὺς - noun, masculine; nominative singular of <Θησεύς> - Theseus - var.us

Θήχης - noun, feminine; nominative singular of <Θήχης> - Theches - var.pname

θοὰς - adjective; accusative plural feminine <θοός> - fast - var.os--h--on

Θρήικες - noun, masculine; nominative plural of <Θρῆ́ιξ> - Thracian

θύγατερ - noun, feminine; vocative singular of <θυγάτηρ> - daughter - var.hr-eros

θυγάτρα - noun, feminine; accusative singular of <θυγάτηρ> - daughter

θυμιᾶται - verb; 3rd person singular present middle of <θυμιάω> - burn with smoke

θυμόν - noun, masculine; accusative singular of <θυμός> - soul, heart - var.os

θυμὸν - noun, masculine; accusative singular of <θυμός> - soul, heart

θωμαστά - adjective; nominative plural neuter of <θωμαστός> - wonderful - var.os--h--on

Ἰθάκην - noun, feminine; accusative singular of <Ἰθάκη> - Ithaca - var.h

καί - conjunction; <καί> - and

καὶ - conjunction; <καί> - and

καθ' - preposition; <κατά> - completely, down, under

καθαραὶ - adjective; nominative plural feminine of <καθαρός> - clean, pure - var.os--a--on

κακήν - adjective; accusative singular feminine of <κακός> - evil, poor - var.os--h--on

κακὸν - adjective; accusative singular masculine of <κακός> - evil, poor

κακοῖσιν - adjective; dative plural neuter of <κακός> - evil, poor

καλέονται - verb; 3rd person plural present passive of <καλέω> - call, summon

καλεῖσθαι - verb; infinitive passive of <καλέω> - call, summon

καλλίστοις - adjective; dative plural neuter of superlative of <καλός> - good, beautiful - var.os--h--on

καλούμενον - verb; accusative singular masculine of present participle passive of <καλέω> - call, summon

κάλυψεν - verb; 3rd person singular aorist of <καλύπτω> - cover

Καλυψὼ - noun, feminine; nominative singular of <Καλυψώ> - Calypso - var.pname

καμάτου - noun, masculine; genitive singular of <κάματος> - toil, labor - var.os

κανναβίδα - noun, feminine; accusative singular of <κάνναβις> - hemp - var.is-idos

καννάβιος - noun, feminine; genitive singular of <κάνναβις> - hemp

κάνναβις - noun, feminine; nominative singular of <κάνναβις> - hemp

καιομένης - verb; genitive singular feminine of participle middle of <καίω> - burn

κάρτα - adverb; <κάρτα> - very much, extremely

κατ' - preposition; <κατά> - completely, down, under

κατὰ - adverb; <κατά> - completely, down, under

κατὰ - preposition; <κατά> - completely, down, under

καταπλάσσονται - verb; 3rd person plural present of <καταπλάσσω> - plaster over

καταπλαστὺν - noun, feminine; accusative singular of <καταπλαστύς> - plaster - var.us

κατασωχόμενον - verb; accusative singular neuter of present participle middle of <κατασώχω> - rub in pieces

κατασώχουσι - verb; 3rd person plural present of <κατασώχω> - rub in pieces

κατελεῖν - verb; infinitive aorist of <καθαιρέω> - take down, destroy

κάτω - adverb; <κάτω> - downward

κέδρου - noun, feminine; genitive singular of <κέδρος> - cedar - var.os

ἱκέσθαι - deponent verb; infinitive aorist middle of <ἱκνέομαι> - reach

κεχρημένον - verb; accusative singular masculine of perfect participle middle of <χράομαι> - need, use

κεχωρίσθαι - verb; infinitive perfect passive of <χωρίζω> - separate

κληθέντες - verb; nominative plural masculine aorist participle passive of <καλέω> - call, summon

κολωνὸν - noun, masculine; accusative singular of <κολωνός> - heap - var.os

κομιζομένην - verb; accusative singular feminine of passive participle of <κομίζω> - provide for

κοινῇ - adjective; dative singular feminine of <κοινός> - common - var.os--h--on

κοσμήτορε - noun, masculine; accusative dual of <κοσμήτωρ> - commander - var.wr-oros

κόσμιός - adjective; nominative singular masculine of <κόσμιος> - orderly - var.os--a--on

κόσμῳ - noun, masculine; dative singular of <κόσμος> - beauty, order, world - var.os

κοσμίῳ - noun, masculine; dative singular of <κόσμιος> - decorum, order

κρατερόφρονα - adjective; accusative singular masculine of <κρατερόφρων> - stout-hearted, dauntless - var.wn-on-fem

κρατήσας - verb; nominative singular masculine of aorist participle of <κρατέω> - hold fast, take to heart; rule, conquer

κραυγὴ - noun, feminine; nominative singular of <κραυγή> - shout - var.h

Κρήτην - noun, feminine; accusative singular of <Κρήτη> - Crete - var.h

Κρονίδης - noun, masculine; nominative singular  of <Κρονίδης> - son of Kronos - var.pname

Κρόνου - noun, masculine; genitive singular of <Κρόνος> - Cronos - var.os

κύνεσσιν - noun, masculine; dative plural of <κύων> - dog - var.wn-on - var.excl

κυπαρίσσου - noun, masculine; genitive singular of <κυπαρίσσος> - cypress - var.os

κώ - adverb; <κώ> - yet

λάβωσι - verb; 3rd person plural aorist subjunctive of <λαμβάνω> - receive, capture

Λακεδαιμονίης - adjective; genitive singular feminine of <Λακεδαιμόνιος> - Lacedemonian, Spartan - var.os--on

λαμπραί - adjective; nominative plural feminine of <λαμπρός> - shiny - var.os--a--on

λαοί - noun, masculine; nominative plural of <λαός> - people - var.os

λαῶν - noun, masculine; genitive plural of <λαός> - people

λιβάνου - noun, masculine; genitive singular of <λίβανος> - frankincense, frankincense tree - var.os

λέγειν - verb; infinitive of <λέγω> - say

λέγοντας - verb; accusative plural masculine of present participle of <λέγω> - say

λέγουσι - verb; 3rd person plural present of <λέγω> - say

λέγουσιν - verb; 3rd person plural present of <λέγω> - say

λέγω - verb; 1st person singular present of <λέγω> - say

λέγων - participle; nominative singular masculine of present participle of <λέγω> - say

λέξιν - noun, feminine; accusative singular of <λέξις> - style - var.is-eos

λέξις - noun, feminine; nominative singular of <λέξις> - style

λευκογραφήσας - verb; nominative singular masculine of aorist participle of <λευκο-γραφέω> - paint in white on a black background

λευκοῖς - adjective; dative plural neuter of <λευκός> - white - var.os--h--on

λευκοῦ - adjective; genitive singular masculine of <λευκός> - white

λήθην - noun, feminine; accusative singular of <λήθη> - forgetting - var.h

Λητοῦς - noun, feminine; genitive singular of <Λητώ> - Leto - var.pname

λίθον - noun, masculine; accusative singular of <λίθος> - stone - var.os

λίθου - noun, masculine; genitive singular of <λίθος> - stone

λίθους - noun, masculine; accusative plural of <λίθος> - stone

λίθων - noun, masculine; genitive plural of <λίθος> - stone

λιλαιομένη - verb; nominative singular feminine of present participle middle of <λιλαίομαι> - desire

λίνεον - adjective; accusative singular neuter of <λίνεος> - of linen - var.os--a--on

λινέοισι - adjective; dative plural neuter of <λίνεος> - of linen

λίνου - noun, neuter; genitive singular of <λίνον> - linen - var.on

λίνῳ - noun, neuter; dative singular of <λίνον> - linen

λόγον - noun, masculine; accusative singular of <λόγος> - word, reason - var.os

λόγῳ - noun, masculine; dative singular of <λόγος> - word, reason

λόγων - noun, masculine; genitive plural of <λόγος> - word, reason

λούονται - verb; 3rd person plural present middle of <λούομαι> - wash oneself

λουτροῦ - noun, neuter; genitive singular of <λουτρόν> - bathing - var.on

λοχαγοὺς - noun, masculine; accusative plural of <λοχαγός> - captain - var.os

λίσσετο - verb; 3rd person singular imperfect of <λίσσομαι> - pray

Λύκιον - noun, masculine; accusative singular of <Λύκιος> - Lycius - var.os

λύσαιτε - verb; 2nd person plural optative aorist of <λύω> - loosen, free

λυσόμενός - verb; nominative singular masculine of future participle middle of <λύω> - loosen, free

# μία - adjective; nominative singular feminine of <εἷς> - one -var.excl

μάλα - adverb; <μάλα> - very

μᾶλλον - adverb; <μᾶλλον> - more and more

μάλιστα - adverb; superlative of <μάλα> - very

μάχεσθαι - verb; infinitive middle of <μάχομαι> - fight, quarrel

μαχόμενον - deponent verb; accusative singular masculine of present participle of <μάχομαι> - fight, quarrel

μεγάθεος - noun, feminine; genitive singular of <μεγάθης> - height - var.hs-es

μεγάλα - adjective; nominative plural neuter of <μεγάλος> - great - var.os--h--on

μεγάλως - adverb; <μεγάλως> - greatly

# μέγαν - adjective; accusative singular masculine of <μέγας> - great - var.excl

μεγέθει - noun, neuter; dative singular of <μέγεθος> - size - var.os-ous

# μεῖζόν - adjective; nominative singular neuter of comparative of <μέγας> - great

# μείζων - adjective; nominative singular feminine of comparative of <μέγας> - great

μελιᾶν - noun, feminine; genitive plural of <μελία> - the ash tree - var.a

μελετῆσαι - verb; aorist infinitive of <μελετάω> - care for, practice

μεμείχεται - verb; 3rd person singular perfect passive of <μίγνυμι> - mix

μὲν - particle; <μέν> - on the one hand

μενέαινεν - verb; 3rd person singular imperfect of <μεναίνω> - rage

μέντοι - particle; <μέντοι> - but, however

μερίμνας - noun, feminine; accusative plural of <μέριμνα> - care, anxious thought - var.a

μερόπων - noun, masculine; genitive plural  of <μέροψ> - endowed with speech -var.ps

μετὰ - preposition; <μετά> - after, with

μετόπισθεν - adverb; <μετόπισθε> - afterwards

μέχρι - preposition; <μέχρι> - until

μὴ - particle; <μή> - not

μηδ' - particle; <μηδέ> - and not

μηδὲ - particle; <μηδέ> - and not

Μηδείης - noun, feminine; genitive singular of <Μηδεία> - Medea - var.a

μὴν - particle; <μήν> - verily

μῆνιν - noun, feminine; accusative singular of <μῆνις> - anger - var.is-eos

μήτε - adverb; <μήτε> - and not, neither

μηχανὴν - noun, feminine; accusative singular of <μηχανή> - instrument - var.h

μιμεῖσθαι - deponent verb; infinitive middle of <μιμέομαι> - imitate

μιμεῖσθαί - deponent verb; infinitive middle of <μιμέομαι> - imitate

μίμησις - noun, feminine; nominative singular of <μίμησις> - representation - var.is-eos

μιν - pronoun; accusative singular neuter of <μιν> - it

Μίνω - noun, masculine; genitive singular of <Μίνος> - Minos - var.os

μοι - pronoun; dative singular masculine of <ἐγώ> - I

μόνον - adverb; <μόνον> - alone

μούνας - adjective; accusative plural feminine of <μόνος> - alone - var.excl

Μοῦσα - noun, feminine; vocative singular of <Μοῦσα> - Muse - var.a

μῦθος - noun, masculine; nominative singular of <μῦθος> - speech, plot - var.os

μυρί' - adjective; accusative plural neuter of <μυρίος> - countless - var.os--a--on

ναός - noun, masculine; nominative singular of <ναός> - temple - var.os

ναῦν - noun, feminine; accusative singular of <ναῦς> - ship - var.diph-aus

ναῦς - noun, feminine; nominative singular of <ναῦς> - ship

νέεσθαι - verb; infinitive middle of <νέομαι> - return

νῆας - noun, feminine; accusative plural of <ναῦς> - ship

νήπιοι - adjective; nominative plural masculine of <νήπιος> - childish, foolish - var.os--a--h--on

Νίκης - noun, feminine; genitive singular of <Νίκη> - Victory - var.h

νόημα - noun, neuter; accusative singular of <νόημα> - thought, understanding - var.a-atos

νόον - noun, masculine; accusative singular of <νόος> - mind - var.ous

νόστιμον - adjective; accusative singular neuter of <νόστιμος> - returning - var.os--on

νόστον - noun, masculine; accusative singular of <νόστος> - return - var.os

νόστου - noun, masculine; genitive singular of <νόστος> - return

νόσφι - preposition; <νόσφι> - apart, afar, except

νόσφιν - adverb; <νόσφι> - apart, afar, except

νοῦσον - noun, feminine; accusative singular of <νούσος> - sickness - var.os

νύκτωρ - adverb; <νύκτωρ> - by night

νύμφη - noun, feminine; nominative singular of <νύμφη> - nymph - var.h

νῦν - adverb; <νῦν> - now

Ξενοφῶν - noun, masculine; nominative singular of <Ξενοφῶν> - Xenophon - var.wn-ontos

Ξενοφῶντι - noun, masculine; dative singular of <Ξενοφῶν> - Xenophon

Ξενοφῶντος - noun, masculine; genitive singular of <Ξενοφῶν> - Xenophon

ξύλου - noun, neuter; genitive singular of <ξύλον> - wood - var.on

ξύμπαντας - adjective; accusative plural masculine of <ξύμπας> - all together - var.as-antos

ξύμπαντες - adjective; nominative plural masculine <ξύμπας> - all together

ξύμπασά - adjective; nominative singular feminine of <ξύμπας> - all together

ξυμπάσης - adjective; genitive singular feminine of <ξύμπας> - all together

ξυνέηκε - verb; 3rd person singular aorist of <συνίημι> - bring together

ξυνίεσαν - verb; 3rd person plural imperfect of <ξυνίημι> - bring together, understand

ξυνῆλθον - deponent verb; 3rd person plural aorist of <συνέρχομαι> - unite, come together

ὅ - relative pronoun; accusative singular neuter of <ὅς> - who, which

ὁ - article used as pronoun; nominative singular masculine of <ὁ> - the

ὁ - article; nominative singular masculine of <ὁ> - the

οἱ - reflexive pronoun; dative singular masculine of <σφεῖς> - they

οἳ - relative pronoun; nominative plural masculine of <ὅς> - who, which

οἵ - relative pronoun; nominative plural masculine of <ὅς> - who, which

ὅ - article; nominative singular masculine of <ὁ> - the

ὅ - relative pronoun; nominative singular neuter of <ὅς> - who, which

οἱ - article; nominative plural masculine of <ὁ> - the

ὃ - relative pronoun; nominative singular neuter of <ὅς> - who, which

οἳ - demonstrative pronoun; nominative plural masculine of <ὅς> - this, that, he, she, it

οἷα - relative pronoun; accusative neuter plural of <οἷος> - like, such that

ὄβριμον - adjective; accusative singular neuter of <ὄβριμος> - strong - var.os--on

Ὀδυσῆι - noun, masculine; dative singular of <Ὀδυσεύς> - Odysseus - var.pname

οἴει - deponent verb; 2nd person singular present middle of <οἶμαι> - think

οἰζύος - noun, feminine; genitive singular of <οἰζύς> - misery, suffering - var.us

οἴκαδ' - adverb; <οἴκαδε> - home

οἰκηιεῦνται - verb; 3rd person singular present middle of <οἰκηιεύω> - claim

οἴκοι - adverb; <οἴκοι> - at home

οἶκόνδε - adverb; <οἶκόνδε> - to his home

ὄλεθρον - noun, masculine; accusative singular of <ὄλεθρος> - destruction - var.os

ὀλέκοντο - verb; 3rd person plural imperfect passive of <ὀλέκω> - kill

ὄλοντο - verb; 3rd person plural aorist of <ὄλλυμαι> - perish

Ὀλύμπια - adjective; accusative plural neuter of <Ὀλύμπιος> - Olympian - var.os--on

ὅλως - adverb; <ὅλως> - wholly

Ὅμερος - noun, masculine; nominative singular of <Ὅμερος> - Homer - var.os

ὁμιλίᾳ - noun, feminine; dative singular of <ὁμιλία> - being together - var.a

ὁμιλεῖ - verb; 3rd person singular present of <ὁμιλέω> - consort with, busy oneself with

ὁμιλῶν - verb; nominative singular masculine of present participle of <ὁμιλέω> - consort with, busy oneself with

ὁμοῖον - adjective; accusative singular neuter of <ὅμοιος> - like, similar - var.os--a--on

ὁμοιότατα - adjective; accusative plural neuter superlative of <ὅμοιος> - like, similar

ὁμοίως - adverb; <ὁμοίως> - similarly

ὃν - possessive pronoun; accusative singular masculine of <ὅς> - his

ὄνομα - noun, neuter; nominative singular of <ὄνομα> - name - var.a

ὄνομα - noun, neuter; accusative singular of <ὄνομα> - name

ὀνομασίαν - noun, feminine; accusative singular of <ὀνομασία> - language - var.a

οἶον - adverb; <οἶον> - so to say

οἶον - adjective; accusative singular masculine of <οἶος> - alone - var.os--a--on

ὅπερ - relative pronoun; nominative singular neuter of <ὅσπερ> - it

οἵπερ - article used as demonstrative pronoun; nominative plural masculine of <ὁ> - the + particle; <περ> - indeed

ὁποῖά - interrogative pronoun; accusative plural neuter of <ὁπος> - what sort of

ὄπισθεν - adverb; <ὄπισθεν> - behind

ὀπισθοφύλακες - noun, masculine; nominative plural of <ὀπισθοφύλαξ> - rear-guard

ὀπίσω - adverb; <ὀπίσω> - back

ὁρᾷ - verb; 3rd person singular present of <ὁράω> - see

ὄρει - noun, neuter; dative singular of <ὄρος> - mountain - var.os-ous

ὄρος - noun, neuter; accusative singular of <ὄρος> - mountain

ὄρους - noun, neuter; genitive singular of <ὄρος> - mountain

ὀροφὴν - noun, feminine; accusative singular of <ὀροφή> - roof - var.h

ὁρῶντας - verb; accusative plural masculine of participle of <ὁράω> - see

ὅς - demonstrative pronoun; nominative singular masculine of <ὅς> - this, that, he, she, it

οἷσι - possessive pronoun; dative plural masculine of <ὅς> - his

οἵς - relative pronoun; dative plural masculine of <ὅς> - who, which

οἷς - demonstrative pronoun; dative plural neuter of <ὅς> - this, that, he, she, it

ὅς - relative pronoun; nominative singular masculine of <ὅς> - who, which

οἶσι - participle; dative plural neuter of present participle of <εἰμί> - I am

οἷσιν - demonstrative pronoun; dative plural masculine of <ὅς> - this, that, he, she, it

ὅσοι - relative pronoun; nominative plural masculine of <ὅσος> - as many

ὅστις - relative pronoun; nominative singular masculine of <ὅστις> - whoever, whatever

ὅσῳ - relative pronoun; dative singular neuter of <ὅσος> - as many

ὅτ' - conjunction; <ὅτε> - when

ὅτι - conjunction; <ὅτι> - because, that

ὅτε - conjunction; <ὅτε> - when

ὅτου - pronoun; genitive singular masculine of <ὅτος> - someone

ὅτῳ - relative pronoun; dative singular neuter of <ὅστις> - whoever, whatever

οὗ - relative pronoun; genitive singular neuter <ὅς> - who, which

οὐ - particle; <οὐ> - not

οὐδ' - particle; <οὐδέ> - not

οὐδαμοῦ - adverb; <οὐδαμοῦ> - nowhere

οὐδέ - particle; <οὐδέ> - not

οὐδὲ - particle; <οὐδέ> - not

οὐδεμία - pronoun; nominative singular feminine of <οὐδείς, οὐδεμία, οὐδέν> - no one, nothing

οὐδὲν - pronoun; nominative singular neuter of <οὐδείς, οὐδεμία, οὐδέν> - no one, nothing

οὐδὲν - adverb; <οὐδέν> - in no way

οὐδὲν - pronoun; accusative singular neuter of <οὐδείς, οὐδεμία, οὐδέν> - no one, nothing

οὐκ - particle; <οὐκ> - not

οὐλομένην - participle; accusative singular feminine of present participle middle of <ὀλόω> - to destroy

οὖν - adverb; <οὖν> - indeed

οὕνεκα - conjunction; <οὕνεκα> - because

οὐρανῷ - noun, masculine; dative singular of <οὐρανός> - heaven - var.os

οὖσα - verb; nominative singular feminine of present participle of <εἰμί> - I am

οὔτ' - adverb; <οὔτε> - neither, nor

οὔτε - adverb; <οὔτε> - neither, nor

οὔτω - adverb; <οὔτω> - thus

οὕτω - adverb; <οὕτως> - so, thus

οὐχ - particle; <οὐ> - not

οἰωνοῖσί - noun, masculine; dative plural of <οἰωνός> - large bird, bird of prey - var.os

παῖδα - noun, masculine/feminine; accusative singular of <παῖς> - child - var.is-idos

παῖδας - noun, masculine/feminine; accusative plural of <παῖς> - child

παῖδές - noun, masculine/feminine; nominative plural of <παῖς> - child

παίδων - noun, masculine/feminine; genitive plural of <παῖς> - child

πάθεν - verb; 3rd person singular aorist of <πάσχω> - suffer

παλαιῶν - adjective; genitive plural masculine of <παλαιός> - old, ancient - var.os--a--on

πᾶν - adjective; accusative singular neuter of <πᾶς> - all, every - var.excl

πάντα - adjective; accusative plural neuter of <πᾶς> - all, every

παντάπασι - adverb; <παντάπασι> - absolutely

πάντας - adjective; accusative plural masculine of <πᾶς> - all, every

πάντες - adjective; nominative plural masculine of <πᾶς> - all, every

πάντως - adverb; <πάντως> - altogether

πάνυ - adverb; <πάνυ> - at all

παρ' - preposition; <παρά> - from, of

παράπαν - adverb; <παράπαν> - absolutely

παραπλήσιον - adjective; nominative singular neuter of <παραπλήσιος> - such-like - var.os--a--on

παραχέουσαι - verb; nominative plural feminine of present participle of <παραχέω> - pour in

παρεβοήθει - verb; 3rd person singular imperfect of <παραβοηθέω> - come up to help

παρεγγυήσαντος - verb; genitive singular masculine of aorist participle of <παρεγγυάω> - pass along

παρεγγυώντων - verb; genitive plural masculine of participle of <παρεγγυάω> - pass along

παρέχεσθαι - verb; passive infinitive of <παρέχω> - provide

παρέχεται - verb; 3rd person singular present middle of <παρέχω> - provide

πάρος - conjunction; <πάρος> - until

πᾶσι - adjective; dative plural neuter of <πᾶς> - all, every

πᾶσι - adjective; dative plural masculine of <πᾶς> - all, every

πᾶσα - adjective; nominative singular feminine of <πᾶς> - all, every

πατέρα - noun, masculine; accusative singular of <πατήρ> - father - var.hr-eros

πατὴρ - noun, masculine; nominative singular of <πατήρ> - father

παύονται - verb; 3rd person plural present middle of <παύω> - stop, cease

παχὺ - adjective; accusative singular neuter of <παχύς> - thick - var.us

παχύτητος - noun, feminine; genitive singular of <παχύτης> - thickness - var.hs-htos

Πελασγικὸν - adjective; accusative singular neuter of <Πελασγικός> - Pelasgian - var.os--h--on

πέμπτῇ - adjective; dative singular feminine of <πέμπτος> - fifth - var.os--h--on

πέμψαντας - verb; accusative plural masculine of aorist participle of <πέμπω> - send

πεποιημέναι - verb; participle perfect middle of <ποιέω> - make, do

περὶ - preposition; <περί> - around

περ - adverb; <πέρ> - although

περιέβαλλον - verb; 3rd person plural imperfect of <περιβάλλω> - throw around

περιπλομένων - verb; genitive plural masculine of present middle participle of <περιπέλομαι> - revolve

Πέρσαι - noun, masculine; nominative plural of <Πέρσης> - Persian - var.pname

πεφευγότες - verb; nominative plural masculine of perfect participle of <φεύγω> - escape, flee

πεφυγμένος - verb; nominative singular masculine of perfect participle middle of <φεύγω> - escape, flee

Πηληιάδεω - noun, masculine; genitive singular of <Πηληιάδης> - son of Peleus - var.pname

πλάγχθη - verb; 3rd person singular aorist passive of <πλάζω> - wander, toss

πλάττειν - verb; infinitive of <πλάττω> - mould, shape

πλέῃ - verb; 3rd person singular present optative of <πλέω> - sail

πλείους - adjective; accusative plural masculine of comparative of <πολύς> - many

πλεῖστον - adjective; accusative singular neuter of <πλεῖστος> - most - var.excl

πλείω - adjective; accusative singular feminine comparative of <πολύς> - many

πλείων - adjective; nominative singular feminine comparative of <πολύς> - many

πλὴν - preposition; <πλήν> - except

πῖλους - noun, masculine; accusative plural of <πῖλος> - mat - var.os

ποιεῦνται - verb; 3rd person plural present middle of <ποιέω> - make, do

ποίησ' - verb; 3rd person singular aorist of <ποιέω> - make, do

ποιησάμενοι - verb; nominative plural masculine of aorist middle participle of <ποιέω> - make, do

ποίησαν - verb; 3rd person plural aorist of <ποιέω> - make, do

ποίησε - verb; 3rd person singular aorist of <ποιέω> - make, do

πολέμιον - adjective; accusative singular neuter of <πολέμιος> - hostile, inimical - var.os--a--on

πόλεμόν - noun, masculine; accusative singular of <πόλεμος> - war - var.os

πολεμίους - noun, masculine; accusative plural of <πολέμιος> - enemy

πόλεις - noun, feminine; accusative plural of <πόλις> - city - var.is-eos

πόλεις - noun, feminine; nominative plural of <πόλις> - city

πολλὰ - adjective; accusative plural neuter of <πολύς> - many

πολλὰς - adjective; accusative plural feminine of <πολύς> - many

πολλὴ - adjective; nominative singular feminine of <πολύς> - many

πολλή - adjective; nominative singular feminine of <πολύς> - many

πολλοῦ - adjective; genitive singular masculine of <πολύς> - many

πολλῷ - adverb; dative singular neuter of <πολύς> - many

πολλῶν - adjective; genitive plural masculine of <πολύς> - many

πόλιν - noun, feminine; accusative singular of <πόλις> - city

πολιτικῆς - noun, feminine; genitive singular of <πολιτική> - politics - var.h

πολιτικῶς - adverb; <πολιτικῶς> - like statesmen

πολὺ - adverb; <πολύς> - many

πολύτροπον - adjective; accusative singular masculine of <πολύτροπος> - much-turned, much-traveled - var.os--on

πόντῳ - noun, masculine; dative singular of <πόντος> - sea - var.os

πόνων - noun, masculine; genitive plural of <πόνος> - grief - var.os

ποιοῦσι - verb; 3rd person plural present of <ποιέω> - make, do

Ποσειδάωνος - noun, masculine; genitive singular of <Ποσειδάων> - Poseidon - var.pname

πόσιν - noun, masculine; accusative singular of <πόσις> - husband - var.is-eos

ποτ' - adverb; <ποτέ> - at some time, ever

πότνι' - noun, feminine; nominative singular  of <πότνια> - revered, queenly - var.a

που - adverb; <που> - anywhere, perhaps

πουλυβοτείρῃ - noun, feminine; dative singular  of <πουλυβότειρα> - all nourishing, fruitful - var.a

ἱππέας - noun, masculine; accusative plural of <ἱππεύς> - horseman - var.diph-eos

ἱππέων - noun, masculine; genitive plural of <ἱππεύς> - horseman

ἵπποι - noun, masculine; nominative plural of <ἵππος> - horse - var.os

ἵππον - noun, masculine; accusative singular of <ἵππος> - horse

πραγματείας - noun, feminine; accusative plural of <πραγματεία> - hard work, affairs - var.a

Πριάμοιο - noun, masculine; genitive singular of <Πρίαμος> - Priam - var.os

Πριάμου - noun, masculine; genitive singular of <Πρίαμος> - Priam

πράξεως - noun, feminine; genitive singular of <πράξις> - action in actual life - var.is-eos

πραττόντων - verb; genitive plural masculine of present participle of <πράττω> - achieve, manage

πρὸ - preposition; <πρό> - before

προαίρεσιν - noun, feminine; accusative singular of <προαίρεσις> - choice - var.is-eos

προαιρεῖται - verb; 3rd person singular present middle of <προαιρέω> - choose

προίαψεν - verb; 3rd person singular aorist of <προιάπτω> - send forth

προεῖπε - verb; 3rd person singular aorist of <προ-λέγω> - say beforehand

προεῖχε - verb; singular present of <προείχω> - to be superior, excel

προπύλαια - noun, neuter; nominative plural of <προπύλαια> - gateway - var.a

προπυλαίων - noun, neuter; genitive plural of <προπύλαια> - gateway

πρὸς - preposition; <πρός> - to

προισομένων - verb; genitive plural neuter of aorist participle of <προφέρω> - bring forth

πρόσωπον - noun, neuter; accusative singular of <πρόσωπον> - face - var.on

προτέρη - adjective; nominative singular feminine of <πρότερος> - first, before - var.os--a--on

πρότερον - adverb; <πρότερον> - earlier, before

προτέρους - adjective; accusative plural masculine of <πρότερος> - first, before

προφέρειν - verb; infinitive of <προφέρω> - bring forth

πρῶτα - adverb; accusative plural neuter of <πρῶτος> - first

πρῶτοι - adjective; nominative plural masculine of <πρῶτος> - first

πρῶτοι - adjective; nominative plural masculine of <πρῶτος> - first

πρῶτὸν - adverb; <πρῶτον> - first

πρώτιστα - adverb; <πρώτιστα> - first of all

πτολίεθρον - noun, neuter; accusative singular of <πτολίεθρον> - city - var.on

πυρί - noun, neuter; dative singular of <πῦρ> - fire - var.excl

πυρίη - noun, feminine; nominative singular of <πυρίη> - vapor bath - var.h

πυρίῃ - noun, feminine; dative singular of <πυρίη> - vapor bath

πω - adverb; <πω> - yet

ῥητορικῆς - noun, feminine; genitive singular of <ῥητορική> - rhetoric - var.h

ῥητορικῶς - adverb; <ῥητορικῶς> - like rhetoricians

ῥίψας - verb; nominative singular masculine of aorist participle of <ῥίπτω> - throw down

σαφῶς - adverb; <σαφῶς> - truly

σιδήρεον - adjective; nominative singular neuter of <σιδήρεος> - of iron - var.os--a--h--on

σκήπτρῳ - noun, neuter; dative singular of <σκήπτρον> - sceptre - var.on

Σκύθαι - noun, masculine; nominative plural of <Σκύθης> - Scythian - var.pname

σπέρμα - noun, neuter; accusative singular of <σπέρμα> - seed - var.a

σπειρομένη - verb; nominative singular feminine of present participle passive of <σπείρω> - sow

σπέσσι - noun, neuter; dative plural of <σπέος> - cave, grotto - var.os-ous

στέμματ' - noun, neuter; accusative plural of <στ́εμμα> - wreath, garland - var.a

στόλον - noun, masculine; accusative singular of <στόλος> - army - var.os

σῖτον - noun, masculine; accusative singular of <σῖτος> - corn, bread - var.os

στονόεντα - adjective; nominative singular neuter of <στονόεις> - sad, wretched - var.eis

ἱστορίης - noun, feminine; genitive singular of <ἱστορία> - inquiry, history

ἱστίοις - noun, neuter; dative plural of <ἱστίον> - sail - var.on

στρατείαν - noun, feminine; accusative singular of <στρατεία> - expedition

στρατεύεσθαι - verb; infinitive middle of <στρατεύω> - take the field, attack

στρατηγοὺς - noun, masculine; accusative plural of <στρατηγός> - general - var.os

στρατὸν - noun, masculine; accusative singular of <στρατός> - army - var.os

στρατιώται - noun, masculine; nominative plural of <στρατιώτης> - soldier - var.hs-ou

στρατιωτῶν - noun, masculine; genitive plural of <στρατιώτης> - soldier

συναγεῖραι - verb; infinitive aorist of <συναγείρω> - assemble

σύνοπτος - adjective; nominative singular feminine of <σύνοπτος> - visible - var.os--on

σφι - reflexive pronoun; dative plural masculine of <σφεῖς> - they

σφέας - reflexive pronoun; accusative plural masculine of <σφεῖς> - they

σφετέρῃσιν - pronoun; dative plural feminine of <σφέτερος> - own

σφίσι - reflexive pronoun; dative plural masculine of <σφεῖς> - they

σφωε - pronoun; accusative dual masculine of <σφωε> - those two

ἴσχει - verb; 3rd person singular present of <ἴσχω> - stay

σχολὴ - noun, feminine; nominative singular of <σχολή> - leisure - var.h

ἰσχυσάντων - verb; genitive plural masculine of participle aorist of <ἰσχύω> - be strong

σῶμα - noun, neuter; accusative singular of <σῶμα> - body

σωφροσύνης - noun, feminine; genitive singular of <σωφροσύνη> - moderation, discretion

τ' - conjunction; <τε> - and

τι - indefinite pronoun; accusative singular neuter of <τις> - someone, something

τι - adverb; <τι> - in any way

τι - indefinite pronoun; nominative singular neuter of <τις> - someone, something

τὰ - article; accusative plural neuter of <ὁ> - the

τά - article; nominative plural neuter of <ὁ> - the

τὰ - article; nominative plural neuter of <ὁ> - the

τὰς - article; accusative plural feminine of <ὁ> - the

ταῦρον - noun, masculine; accusative singular of <ταῦρος> - bull - var.os

ταύρου - noun, masculine; genitive singular of <ταῦρος> - bull

ταῦτὰ - article; accusative plural neuter of <ὁ> - the + pronoun; <αὐτός> - oneself, he

ταῦτα - demonstrative pronoun; nominative plural neuter of <οὗτος> - this

ταῦτα - demonstrative pronoun; accusative plural neuter of <οὗτος> - this

ταύτῃ - demonstrative pronoun; dative singular feminine of <οὗτος> - this

ταύτην - demonstrative pronoun; accusative singular feminine of <οὗτος> - this

ταύτης - demonstrative pronoun; genitive singular feminine of <οὗτος> - this

τάχα - adverb; <τάχα> - presently, soon

τέ - conjunction; <τε> - and

τε - conjunction; <τε> - and

τεθνάναι - verb; infinitive perfect of <θνήσκω> - die

τεκμηριοῖ - verb; 3rd person singular present optative of <τεκμηριόω> - prove positively

τεταγμένα - verb; accusative plural neuter of passive participle of <τάσσω> - arrange, put in order

τέταρτον - adverb; of <τέταρτος> - fourth - var.excl

τέταρτον - adjective; accusative singular neuter of <τέταρτος> - fourth

τεῦχε - verb; 3rd person singular imperfect of <τεύχω> - make ready, make

τεῖχος - noun, neuter; accusative singular of <τεῖχος> - wall - var.os

τῇ - article; dative singular feminine of <ὁ> - the

τὴν - article; accusative singular feminine of <ὁ> - the

τῆς - article; genitive singular feminine of <ὁ> - the

τίθεναι - verb; infinitive of <τίθημι> - put, place

τινὰ - indefinite pronoun; accusative singular neuter of <τις> - someone, something

τινας - indefinite pronoun; accusative plural masculine of <τις> - someone, something

τὸ - article; nominative singular neuter of <ὁ> - the

τὸ - article; accusative singular neuter of <ὁ> - the

τόδε - demonstrative pronoun; accusative singular neuter of <ὅδε> - this

τόλμης - noun, feminine; genitive singular of <τόλμα> - courage, venture

τὸν - article used as pronoun; accusative singular masculine of <ὁ> - the

τὸν - article; accusative singular masculine of <ὁ> - the

τοὄνομα - noun, neuter; accusative singular of <ὄνομα> - article τό + name

τοιοῦτον - pronoun; nominative singular neuter of <τοιοῦτος> - such - var.excl

τοῖς - article; dative plural neuter of <ὁ> - the

τοῖσι - article; dative plural masculine of <ὁ> - the

τοίσι - article; dative plural neuter of <ὁ> - the

τοσαύτην - pronoun; accusative singular feminine of <τοσοῦτος> - such

τοῖσιν - article used as pronoun; dative plural masculine of <ὁ> - the

τοῦ - article; genitive singular masculine of <ὁ> - the

τοῦ - article; genitive singular neuter of <ὁ> - the

τούς - article; accusative plural masculine of <ὁ> - the

τοὺς - article; accusative plural masculine of <ὁ> - the

τοῦτό - demonstrative pronoun; nominative singular neuter of <οὗτος> - this

τοῦτο - demonstrative pronoun; accusative singular neuter of <οὗτος> - this

τοῦτο - demonstrative pronoun; nominative singular neuter of <οὗτος> - this

τούτου - demonstrative pronoun; genitive singular neuter of <οὗτος> - this

τούτων - demonstrative pronoun; genitive plural neuter of <οὗτος> - this

τραγῳδίας - noun, feminine; genitive singular of <τραγῳδία> - tragedy

# τρίβων - adjective; nominative singular masculine of present participle of <τρίβω> - skilled, experienced

τρηχὺν - adjective; accusative singular masculine of <τρηχύς> - rough - var.us

Τροίης - noun, feminine; genitive singular of <Τροίη> - Troy

τρίτον - adjective; nominative singular neuter of <τρίτος> - third - var.excl

τρίτον - adjective; accusative singular neuter of <τρίτος> - third

Τρωικῶν - adjective; genitive plural neuter of <Τρωικός> - Trojan - var.os--h--on

τις - indefinite pronoun; nominative singular masculine of <τις> - someone, something

τίς - interrogative pronoun; nominative singular masculine of <τίς> - who, what

τις - indefinite pronoun; nominative singular feminine of <τις> - someone, something

τῷ - article; dative singular neuter of <ὁ> - the

τῷ - article; dative singular masculine of <ὁ> - the

τῷ - article used as pronoun; dative singular masculine of <ὁ> - the

τῶν - article; genitive plural masculine of <ὁ> - the

τῶν - article used as pronoun; genitive plural neuter of <ὁ> - the

τῶν - article; genitive plural neuter of <ὁ> - the

ὕβριες - noun, neuter; nominative plural of <ὕβρις> - violence - var.is-eos

ὕδατι - noun, neuter; dative singular of <ὕδωρ> - water - var.excl

ὕδωρ - noun, neuter; accusative singular of <ὕδωρ> - water

ὑμῖν - pronoun; dative plural masculine of <σύ> - you

υἱὸν - noun, masculine; accusative singular of <υἱός> - son - var.os

υἱός - noun, masculine; nominative singular of <υἱός> - son

ὑπ' - preposition; <ὑπό> - under, by

Ὑπερίονος - noun, masculine; genitive singular of <Ὑπερίων> - Hyperion - var.pname

ὑπερφέρει - verb; 3rd person singular present of <ὑπερφέρω> - surpass

ὑπὸ - preposition; <ὑπό> - under, by

ὑποδύνουσι - verb; 3rd person plural present of <ὑποδύω> - go under

ὑποζύγια - noun, neuter; nominative plural of <ὑποζύγιον> - pack animal - var.on

ὕστερον - adverb; <ὕστερον> - later

φαίνεται - verb; 3rd person singular present middle of <φαίνω> - seem

φαρμάκοις - noun, neuter; dative plural of <φάρμακον> - paint, color - var.on

φέρουσι - verb; 3rd person plural present of <φέρω> - bear, bring, carry

φέρουσα - verb; nominative singular feminine of participle of <φέρω> - bear, bring, carry

φέρων - verb; nominative singular masculine of present participle of <φέρω> - bear, bring, carry

φεύγει - verb; 3rd person singular present of <φεύγω> - escape, flee

φθειρόμενοι - verb; nominative plural masculine of participle middle of <φθείρω> - perish

ἰφθίμους - adjective; accusative plural feminine of <ἴφθιμος> - valiant - var.os--h--on

φθόνου - noun, masculine; genitive singular of <φθόνος> - envy, ill-will - var.os

Φθιῶτιδι - noun, feminine; dative singular of <Φθιῶτις> - Phthiotis - var.pname

Φθιώτιδος - noun, feminine; genitive singular of <Φθιῶτις> - Phthiotis

φίλην - adjective; accusative singular feminine of <φίλος> - dear, friendly - var.os--h--on

φίλοισι - noun, masculine; dative plural of <φίλος> - dear one, friend

φιλόσοφος - noun, masculine; nominative singular of <φιλόσοφος> - wise man - var.os

φύγον - verb; 3rd person plural aorist of <φεύγω> - escape, flee

φύεται - verb; 3rd person singular present middle of <φύω> - grow

φυὴν - noun, feminine; accusative singular of <φύη> - stature

φυομένη - verb; nominative singular feminine of present participle middle of <φύω> - grow

χαλεπὰς - adjective; accusative plural feminine of <χαλεπός> - difficult - var.os--h--on

χάλκειον - adjective; accusative singular neuter of <χάλκειος> - of bronze - var.os--h--on

χειρότερον - adjective; accusative singular neuter comparative of <κακός> - evil, poor

χερσὶν - noun, feminine; dative plural of <χείρ> - hand - var.ir-iros

χθονὶ - noun, feminine; dative singular of <χθών> - earth - var.wn-on

χολωθεὶς - verb; nominative singular masculine of aorist participle passive of <χολόω> - anger

χρήσεσθαι - deponent verb; infinitive middle of <χράομαι> - need, use

χρύσεον - adjective; accusative singular neuter of <χρύσεος> - golden - var.os--h--on

χρυσέῳ - adjective; dative singular neuter of <χρύσεος> - golden

Χρύσην - noun, masculine; accusative singular of <Χρύσης> - Chryses - var.pname

χρώμενοι - deponent verb; nominative plural masculine middle participle of <χράομαι> - need, use

χύδην - adverb; <χύδην> - at random, promiscuously

χώρας - noun, feminine; genitive singular of <χώρα> - land, country

χώρῃ - noun, feminine; dative singular of <χώρα> - land, country

ψυχὰς - noun, feminine; accusative plural of <ψυχή> - soul - var.h

ψυχὴ - noun, feminine; nominative singular of <ψυχή> - soul

ψυχὴν - noun, feminine; accusative singular of <ψυχή> - soul

ὦ - exclamation; <ῶ> - Oh

ᾠήθησαν - verb; 3rd person plural aorist passive of <οἴομαι> - think, imagine

ὠμοβόεια - adjective; accusative plural neuter of <ὠμοβόειος> - of raw, untanned oxhide - var.os--a--on

ὦν - verb; present participle nominative singular masculine of <εἰμί> - I am

ὦν - adverb; <ὦν> - indeed

ὠνόμασεν - verb; 3rd person singular aorist of <ὀνομάζω> - speak of by name

ὦρσε - verb; 3rd person singular aorist of <ὄρνυμι> - stir up

ὠρύονται - verb; 3rd person plural present middle of <ὠρύομαι> - howl

ὣς - adverb; <ὡς> - so, thus

ὡς - conjunction; <ὡς> - as, thus

ὡς - adverb; <ὡς> - so, thus

ὥσπερ - conjunction; <ὥσπερ> - as

ὥστε - conjunction; <ὥστε> - like, so that

ὠφελίᾳ - noun, feminine; dative singular of <ὠφελία> - aid
